6   13  1
13  13  13  13  13  13  13  13  13  13  13  13  13
10  10  10  10  10  10  10  10  10  10  10  10  10
3   3   3   3   3   3   3   3   3   3   3   3   3
7   7   7   7   7   7   7   7   7   7   7   7   7
8   8   8   8   8   8   8   8   8   8   8   8   8
2   2   2   2   2   2   2   2   2   2   2   2   2   
