13 13 2
1 0 0 0 0 0 0 0 0 0 0 0 0
1 9 0 0 0 0 0 0 0 0 0 0 0
1 9 4 0 0 0 0 0 0 0 0 0 0
1 9 4 2 0 0 0 0 0 0 0 0 0
1 9 4 2 10 0 0 0 0 0 0 0 0
1 9 4 2 10 12 0 0 0 0 0 0 0
1 9 4 2 10 12 8 0 0 0 0 0 0
1 9 4 2 10 12 8 3 0 0 0 0 0
1 9 4 2 10 12 8 3 1 0 0 0 0
1 9 4 2 10 12 8 3 1 9 0 0 0
1 9 4 2 10 12 8 3 1 9 4 0 0
1 9 4 2 10 12 8 3 1 9 4 2 0
13 13 13 13 13 13 13 13 13 13 13 13 10
