15 13 3
10 10 10 10 10 10 10 10 10 10 10 10 10
0 0 0 0 0 0 0 0 0 0 0 0 0
4 4 4 14  14  14  14  14  14  14  14  14  14
0 0 0 0 0 0 0 0 0 0 0 0 0
8 8 8 8 8 8 8 8 8 8 8 8 8
0 0 0 0 0 0 0 0 0 0 0 0 0
14  14  14  14  14  14  14  14  14  14  3 3 3
0 0 0 0 0 0 0 0 0 0 0 0 0
11  11  11  11  11  11  11  11  11  11  11  11  11
0 0 0 0 0 0 0 0 0 0 0 0 0
8 8 8 14  14  14  14  14  14  14  14  14  14
0 0 0 0 0 0 0 0 0 0 0 0 0
12  12  12  12  12  12  12  12  12  12 12  12  12
0 0 0 0 0 0 0 0 0 0 0 0 0
14  14  14  14  14  14  14  14  14  14  7 7 7
