16 11 4

0 0 3 0 0 0 0 0 3 0 0
0 0 3 0 0 0 0 0 3 0 0
0 0 0 3 0 0 0 3 0 0 0
0 0 0 3 0 0 0 3 0 0 0
0 0 13 13 13 13 13 13 13 0 0
0 0 13 13 13 13 13 13 13 0 0
0 13 13 10 13 13 13 10 13 13 0
0 13 13 10 13 13 13 10 13 13 0
13 13 13 13 13 13 13 13 13 13 13
13 13 13 13 13 13 13 13 13 13 13
13 13 13 13 13 13 13 13 13 13 13
13 0 13 13 13 13 13 13 13 0 13
13 0 13 0 0 0 0 0 13 0 13
0 0 0 13 13 0 13 13 0 0 0
0 0 0 13 13 0 13 13 0 0 0
