10 10
0 0 0 0 0 0 0 0 0 0
0 0 0 0 0 0 0 0 0 0
0 0 0 0 0 0 0 0 0 0
0 0 0 0 0 0 0 0 0 0
4 1 4 1 4 1 4 1 4 1
3 2 3 2 3 2 3 2 3 2
2 3 2 3 2 3 2 3 2 3
1 4 1 4 1 4 1 4 1 4
0 0 0 0 0 0 0 0 0 0
0 0 0 0 0 0 0 0 0 0
