10 10
3 0 4 0 9 0 10 0 12 13
0 3 0 4 0 8 0 10 0 12
0 0 3 0 4 0 7 0 11 0
0 0 0 2 0 5 0 7 0 11
0 0 0 0 2 0 5 0 7 0
0 0 0 0 0 2 0 5 0 7
0 0 0 0 0 0 2 0 6 0
0 0 0 0 0 0 0 1 0 6
0 0 0 0 0 0 0 0 1 0
0 0 0 0 0 0 0 0 0 1
