14 13 2

0 0 0 0 0 0 0 0 0 0 0 0 0
13 13 13 0 13 0  0 0 13 0 13 13 0
13 0  0  0 13 13 0 0 13 0 13 0  13
13 13 0  0 13 0 13 0 13 0 13 0  13
13 0  0  0 13 0 0 13 13 0 13 0  13
13 13 13 0 13 0 0 13 13 0 13 13 0
0 0 0 0 0 0 0 0 0 0 0 0 0
14 14 14 14 0 0 0 0 0  14 14 14 14
0 0 0 0 0 0 0 0 0 0 0 0 0
0 0 0 0 0 0 0 0 0 0 0 0 0
0 0 0 14 14 14 14 14 14 14 0 0 0
0 0 0 0 0 0 0 0 0 0 0 0 0
0 0 0 0 0 0 0 0 0 0 0 0 0
14 14 14 14 0 0 0 0 0  14 14 14 14

